Bdyoginicez@aol.com	hardbounced
camillethai@sbcglobal.net	hardbounced
clairelorich@yahoo.com	hardbounced
duguela1@bellsouth.net	hardbounced
fshlcsw@pacbell.net	hardbounced
hittktky@directcon.net	hardbounced
jill@ajduran.com	hardbounced
jlovitz@earthlink.net	hardbounced
jpicone@selvinwraith.com	hardbounced
kgenlkentang@hotmail.com	hardbounced
LAURENEDANGELO@YAHOO.COM	hardbounced
LEAGLE1DELTA@YAHOO.COM	hardbounced
lizzygamb@sbcglobal.net	hardbounced
marsgirljh@yahoo.com	hardbounced
morning.star.rising@hotmail.com	hardbounced
mspencer@ev1.net	hardbounced
nedratw@sbcglobal.net	hardbounced
oenvuhomas@aol.com	hardbounced
palaaponi@yahoo.com	hardbounced
sharmeller@wi.rr.com	hardbounced
simone@sammasati.net	hardbounced
srodriguez@feedavillage.org	hardbounced
starisprung@aol.com	hardbounced
swagnerpt@comcast.com	hardbounced
swborg@start.no	hardbounced
temenos4@yahoo.ca	hardbounced
terri@yogitimes.com	hardbounced
traveler2theworld@aol.com	hardbounced
yoga-G@hotmail.com	hardbounced
anna@trinityyoga.net	hardbounced
Jan.Sinclair@bigpond.com	hardbounced
ambikasayurveda@sbc.global.net	softbounced
ayurvedacathy@yahoo.com	unsubscribed
brajesh@mountmadonna.org	unsubscribed
daxlumi@comcasst.net	softbounced
diannacarrie@aol.com	softbounced
elizabeth@aumedicine.com	softbounced
fullcircleinsc@sbcglobal.net	unsubscribed
HCHOU668@YAHOO.COM	unsubscribed
heyraneh@yahoo.com	unsubscribed
jillooky@hotmail.com	unsubscribed
kritikos2@earthlink.net	softbounced
lisambordner@yahoo.com	unsubscribed
masterfurny@gmail.com	unsubscribed
Menlogrowers1@aol.com	unsubscribed
michelle.palin@gmail.com	unsubscribed
Patti@Blisskitchen.com	unsubscribed
Roberta@TransFormativeAstrology.com	softbounced
sauravb7@gmail.com	unsubscribed
tebillings@yahoo.com	unsubscribed
